111111111
10P000001
1000E0C01
100000001
111111111