111111111111111111111111111111
1P0111111111111111111111111001
100001111111111111111111100001
100000000000000000000000000001
1000000000CCCCCCCC000000000001
10000000000C0000C00C0000000001
1000000000CC0000CCC00000000001
100000000C0CC000C0000000000001
10000000C000CC00C0000000000001
10000000000C0000C0000000000001
1000000000C00000C0000000000001
10000000CC0000000CCCCC000E0001
100000000000000000000000000001
100001111111111111111111100001
100111111111111111111111111001
111111111111111111111111111111
